N,N,N,N,N,N,N,N,N,
N,N,N,W,W,W,W,W,W,
N,N,N,W,E,E,E,E,W,
W,W,W,W,E,E,E,E,W,
W,E,E,E,E,W,H,E,W,
W,E,E,E,O,W,E,E,W,
W,E,HP,E,E,E,E,E,W,
W,E,E,E,E,W,W,W,W,
W,W,W,W,W,W,N,N,N,
N,N,N,N,N,N,N,N,N,