 , , , , , , , , ,
 , , ,#,#,#,#,#,#,
 , , ,#, , , , ,#,
#,#,#,#, , , , ,#,
#, , , , ,#,H, ,#,
#, , , ,O,#, , ,#,
#, ,h, , , , , ,#,
#, , , , ,#,#,#,#,
#,#,#,#,#,#, , , ,
 , , , , , , , , , 