 , , , , , , , , ,
 ,#,#,#,#,#,#,#, ,
 ,#, , ,#, , ,#, ,
 ,#,H, , , ,H,#, ,
 ,#, , ,C, , ,#, ,
 ,#, , ,H, , ,#, ,
 ,#,#, , , ,#,#, ,
 , ,#,#,h,#,#, , ,
 , , ,#,#,#, , , ,