 , , , , , , , , ,
 , , , , , , , , ,
 , , , , , , , , ,
 , , ,#,#,#,#,#, , 
 ,#,#,#, , , ,#,#,
 ,#,o, ,h, ,h, ,#,
 ,#,#,#, , , ,#,#,
 , , ,#,#,#,#,#, ,
 , , , , , , , , ,
 , , , , , , , , ,
