 , ,#,#,#,#,#, , ,
 , ,#, , , ,#, , ,
#,#,#,H, ,H,#,#,#,
#, , , , , , , ,#,
#, , , ,N, , , ,#,
#, , ,#, ,#, , ,#,
#, ,H, ,n, ,H, ,#,
#, , ,#, ,#, , ,#,
#, , , , , , , ,#,
#,#,#,#,#,#,#,#,#,