 , , , , , , , , ,
 , , , , , , , , ,
 ,#,#,#,#,#,#,#, ,
 ,#, , ,O, , ,#, ,
 ,#, , ,#, , ,#, ,
 ,#, ,h,#,h, ,#, ,
 ,#, , ,#, , ,#, ,
 ,#, , ,O, , ,#, ,
 ,#,#,#,#,#,#,#, ,
 , , , , , , , , ,