 , , , , , , , , ,
 , ,#,#,#,#,#, , ,
 ,#,#, ,h, ,#,#, ,
 ,#, , , , , ,#, ,
 ,#,H, ,O, ,H,#, ,
 ,#, , , , , ,#, ,
 ,#,H,C, ,C,H,#, ,
 ,#, , , , , ,#, ,
 ,#, , ,H, , ,#, , 
 ,#,#,#,#,#,#,#, ,