 , , , , , , , , ,
#,#,#,#,#,#,#,#,#,
#, , , , , , , ,#,
#, ,H, ,C, ,H, ,#,
#, , , , , , , ,#,
#, ,H, ,#, ,H, ,#,
#, , , , , , , ,#,
#, ,H, ,c, ,H, ,#,
#, , , , , , , ,#,
#,#,#,#,#,#,#,#,#,