 , , , , , , , , ,
 , , ,#,#,#, , , ,
 , ,#,#,c,#,#, , ,
 ,#,#, , , ,#,#, ,
#,#, ,H, ,H, ,#,#,
#, , , , , , , ,#,
#,#, ,H, ,H, ,#,#,
 ,#,#, , , ,#,#, ,
 , ,#,#, ,#,#, , ,
 , , ,#,#,#, , , ,
